My age is 25 : omri amsa uae ishrin
Sono italian : ena talieni
Bivo in bologna : naish fi Bologna
Sto mangiando : kaid nekel
Sto bevendo : kaid noshrob
Sto camminando : kaid nimshi
Mucca : bagra
Toro : Thur
Papera : batta
Cane : kalb/a
Gatto : qattous/a
Pesce : hott
Maiale : halloof
Coniglio : arnab
Pecora : naja
Montone : alloush
Farfalla : farasha
Tartaruga : sulahfet
Mio : mtei
Baciare : bous
Un bacio : bousa
Gioco : loaba
Piccolo/a : Giovane : saghir/a
Piccola mia : saghir(ti)
Grande : Vecchio : kbir(a)
Tra/Fra : binet (oggetti) bin (persona)
Uccello : asfur/a
Topo : far
Orso : dib/a
Leone : assad
Tigre : nimr
Ragno : ankbut
Matita : klam
Penna : stilu
Gomma : gom
Temperino : barreya
Astuccio : stush
Zaino/cartella : kartaba
Classe/Aula : class/sala
Alunno : telmidh
Quaderno : korrasa
Università : université
Facoltà : fac
Dipartimento : Department
Maestro : moallem
Professore : prof
Pagina : page/saffha
Teatro : theatre/masrah
Rotonda : rond-point
Semaforo : dhaw
Busta/Sportina/sacchetto : sachet
Chiesa : knisa
Moschea : jema
Museo : musè/matthef
Negozio : hanut


















